#######
#S====#
#=###=#
#=====#
####E##